Gg, Gg, Gg, Gg, Gg, Gg, Gg, Gg, Gg, Gg, Gg, Gg, Gg, Gg, Gg, Gg, Gg, Gg, Hh, Gg, Md, Gg, Hh, Gg, Gg, Gg, Gg, Gg, Gg, Gg, Gg, Gg, Gg, Gg, Gg, Gg, Gg
Wot, Gg, Gg, Gg, Gg, Gg, Gg, Gg, Gg, Gg, Gg, Gg, Gg, Gg, Gg, Gg, Gg, Hh, Hh, Md, Ko, Md, Md, Hh, Hh, Gg, Hh, Gg, Gg, Gg, Gg, Gg, Gg, Gg, Gg, Gg, Gg
Wot, Wot, Wot, Gg, Gg, Gg, Gg^Es, Gg, Gg, Gg, Gg, Gg, Gll^Fmf, Gll^Fmf, Gg, Gg, Gg, Gg^Es, Hh, Co, Co, Co, Hh, Gll^Fp, Hh, Gg, Gs^Fms, Gs^Fds, Gg, Gs^Fms, Gg, Gs^Fms, Gs^Fds, Gg, Gg, Gg, Gg
Wot, Wot, Wot, Wot, Wot, Gg, Gg, Gg, Gg, Gg, Gs^Fms, Gg, Gg, Gg, Gg, Gg, Gg, Gg, Hh, Hh, Hh, Co, Hh, Gll^Fmf, Gg, Gg, Gg, Gs^Fds, Gll^Fmf, Gs^Fms, Gs^Fds, Gg, Gg, Gg, Gg, Gg, Gg
Gg, Wot, Wot, Wot, Wot, Wot, Wot, Gg, Gg, Gg, Gg, Gg^Es, Gg, Gg, Gs^Fms, Gs^Fms, Gs^Fms, Gg^Eff, Gg^Eff, Gg, Gg, Gg, Gg, Hh, Gg, Gg, Gg, Gs^Fms, Gg, Gs^Fms, Gg, Gg, Gg, Gs^Fds, Gll^Fmf, Gg, Gg
Gg, Gg, Gg, Wot, Wot, Wot, Wot, Wot, Wot, Gg, Gg, Gg, Gg, Gg, Gg, Gll^Fmf, Gs^Fds, Gg, Re^Vct, Gg^Eff, Gg^Eff, Gs^Fds, Gg, Gg^Es, Gg, Gg, Gg, Gs^Fds, Gg, Gg, Gg, Gs^Fds, Gg, Gs^Fds, Gs^Fds, Gs^Fds, Gg
Gg, Gg, Gg, Gg, Gg, Wot, Wot, Wot, Wot, Gg, Gg, Gg, Gg^Efm, Gg, Gg^Eff, Gg, Gg, Gg, Gg^Eff, Gg^Eff, Gg, Gg, Gg^Eff, Gg^Eff, Gg^Eff, Gg, Gg, Gg, Gg, Gg, Gg, Gg, Gg, Gg, Gg, Gs^Fds, Gg
Gg, Gg, Gg, Gg^Es, Gg, Gg, Wot, Wot, Wot, Gg, Gg, Gg, Gg, Gg, Gg, Gg^Eff, Gg^Eff, Gg^Eff, Gg, Gg, Gg^Eff, Gg^Eff, Gg, Gg, Re^Vct, Gg^Eff, Gg^Eff, Gg, Gg, Gg, Gg, Gg, Gg, Gg, Gg, Gg, Gg
Gg, Gg, Gg, Gg, Gg, Gg, Wot, Wot, Wot, Wot, Wot, Wot, Wot, Gg, Gg, Gg, Gg, Gg, Gg, Gg, Gg, Gg^Eff, Gg^Eff, Gg^Es, Gg^Es, Gg, Gg^Eff, Gg^Eff, Gg, Gg, Gg, Gg, Gg, Gg, Gg, Gg, Gg
Gg, Gg, Gg, Gg, Gg, Gg, Gg, Wot, Wot, Wot, Wot, Wot, Wot, Wot, Wot, Gg, Gg, Gg, Gg, Gg, Gg, Gg, Gg, Gg^Eff, Gg^Eff, Gg^Eff, Gg, Gg, Gg, Gg, Gg, Gg, Gg, Gg, Gg, Gg, Gg
Gg, Gg, Gg, Gg, Gg, Gg, Gg, Gg, Gg, Wot, Wot, Wot, Wot, Wot, Wot, Wot, Wot, Gg, Gg, Gg, Gg, Gg, Gg, Gg, Gg, Gg, Gg^Efm, Gg, Gg, Gg, Gg, Gg, Gg, Gg, Gg, Gg, Gg
Gg, Gg, Gg, Gg, Gg, Gg, Gg, Gg, Gg, Gg, Gg, Gg, Gg, Wot, Wot, Wot, Wot, Wot, Wwr, Gg, Gg, Gg, Gg, Gg, Gg, Gg, Wot, Gg, Gg, Gg, Wot, Gg, Wot, Gg, Gg, Gg, Gg
Gg, Gg, Gg, Gg, Gg, Gg, Gg, Gg, Gg, Gg, Gg, Gg, Gg, Gg, Gg, Wot, Ww, Wwr, Wwr, Wwr, Wot, Gg, Wot, Wot, Wot, Wot, Wot, Wot, Wot, Wot, Wot, Wot, Wot, Wot, Wot, Gg, Gg
Gg, Gg, Gg, Gg, Gg, Gg, Gg^Gvs, Gg^Gvs, Hh, Gg, Gg, Gg, Gg^Gvs, Gg, Gg^Gvs, Gg, Rp, Rp, Ww^Ewl, Wwt, Wot, Wot, Wot, Wot, Wot, Wot, Wot, Wot, Wot, Wot, Wot, Wot, Wot, Wot, Wot, Wot, Wot
Rp, Gg, Gg, Gg, Rp, Gg^Gvs, Gg^Gvs, Hh^Vhh, Hh, Gg, Gg^Gvs, Gg^Gvs, Gg^Gvs, Gg^Vwm, Gg, Gg, Rr, Gg, Gg, Wwt, Wot, Wot, Wot, Wot, Wot, Wot, Gg, Ww^Ewf, Ww^Ewl, Ww^Ewf, Gg, Gg, Gg, Wot, Wot, Wot, Wot
Gg, Rp, Rp, Rp, Gg, Rp, Rp, Rp, Rp, Gg, Rp, Gg^Gvs, Gg, Gg, Rp, Gg, Rr, Gg, Gg, Gg, Wot, Wot, Wot, Wot, Wot, Gg, Gg, Gg, Gg, Gg, Gg, Gg, Gg, Gg, Gg, Wot, Wot
Gg, Gg, Gg, Gg, Gg, Gg, Gg^Gvs, Gg^Gvs, Gg, Rp, Gg, Rp, Rp, Rp, Gg^Dr, Rr, Gg, Rr, Rr, Ch, Rp^Vhcr, Wot, Wot, Wot, Wot, Gg, Gg, Gg, Gg, Gg, Gg, Gg, Gg, Gg, Gg, Gg, Gg
Gg, Gg, Gg, Gg, Gg^Gvs, Gg^Gvs, Gg^Gvs, Gg^Gvs, Gg^Gvs, Gg, Gg, Gg, Gg, Gg, Gg, Ch, Ket, Ce, Gs^Vh, Rrc, Gg, Chr, Chr, Wot, Wot, Ww^Ewl, Gg^Es, Gg, Gg, Gg, Gg, Gs^Fds, Gs^Vc, Gs^Fds, Gg, Gg, Gg
Gg, Gg, Gg, Gg^Gvs, Gs^Vl, Gg^Gvs, Gd^Fetd, Gg^Gvs, Gg, Gg, Gg, Gg, Gg, Gg, Gg, Gg, Ce, Gg, Gg, Rrc, Gs^Vh, Gg, Gs^Vl, Ch, Wwt, Wwt, Wot, Gg, Gg, Gg^Efm, Gg, Gg^Emf, Gg, Gs^Fds, Gg, Gg, Gg
Gg, Gg, Gg, Gg, Gg^Efm, Gg^Em, Gg, Gg, Gg, Gg, Gg, Gg, Gg^Gvs, Gg^Gvs, Gg^Gvs, Gg, Ce, Gs^Vh, Rrc, Rrc, Gg^Fet, Rrc, Rrc, Rrc, Wwt^Bsb\, Wwt, Wot, Gg, Gg, Gg, Gg, Gs^Fds, Gg, Gg, Ce, Gg, Gg
Gg, Gs^Fds, Gg, Gg, Gg, Gg, Gg, Gg, Gg, Gg, Gg, Gg^Gvs, Gg^Gvs, Gg^Gvs, Gg, Gg, Rr, Rrc, Gs^Vl, Rrc, Rrc, Rrc, Gg, Ce, Wwt, Wwt^Bsb\, Wwt^Bsb\, Gg, Gg, Gg, Gg, Gg, Gg, Ce, Ke, Gg, Gg
Gg, Gs^Fds, Gll^Fp, Gg, Gg, Gg, Gg, Gg, Gg, Gg, Gg, Gs^Vl, Gg, Gg, Rr, Rr, Gg, Ch, Ch, Gg, Gs^Vh, Gg, Gs^Vl, Ce, Wwt, Wwt, Wot, Rp, Rp, Gg^Es, Gg^Efm, Gg, Rp, Ce, Rp, Rp, Rp
Gg, Gg, Gs^Fms, Gs^Fds, Gs^Fds, Gg, Gg, Gg, Gg, Gg, Gg, Gg, Gg, Gg, Rr, Gg, Gg, Gg, Gg, Chr, Gg, Gg, Ce, Ce, Ww^Ewl, Wwt, Wot, Gg, Gg, Rp, Rp, Rp, Gg, Rp, Gg, Gg, Gg
Gg, Gs^Fms, Gs^Fms, Gg, Gg, Gg, Gg, Gg, Gg, Gg, Gg, Gg, Gg^Efm, Gg, Rr, Gg, Gg, Gg, Gg, Gg, Gg, Ce, Gg, Gg, Ww^Ewf, Wwt, Wot, Gg, Hh^Gvs, Gg, Gs^Vc, Gg, Gg, Gg, Gg, Gg, Gg
Gg, Gg, Gll^Fp, Gg, Gs^Fms, Gs^Fds, Gg, Gg, Gg, Gg, Gg, Gg, Gg, Rr, Gg, Gg, Gg, Gg, Gg, Gg, Gg, Gg, Gg, Gg, Wwt, Wwt, Wot, Gg, Hh^Gvs, Gs^Fms, Gll^Fmw, Hh, Gg, Gg, Gg, Gg, Gg
Gg, Gs^Fms, Gs^Fms, Gg, Gs^Fms, Gs^Fds, Gs^Fds, Gg, Gs^Fds, Gg, Gg, Gg, Gg, Rr, Gg, Gg, Gg, Gg, Gg, Gg, Gg, Gg, Gg, Gg, Gg, Wwt, Wwt, Wot, Wot, Hh, Hh, Hh, Gg, Gg, Gg, Gg, Gg
Gg, Gg, Gg, Gg, Gg, Gg, Gg, Gg, Gg, Gg, Gg, Gg, Gg, Rr, Gg, Gg, Gg, Gg, Gg, Gg, Gg, Gg, Gg, Gg, Gg, Gg, Gg, Wwt, Wot, Wot, Gg, Gg, Gg, Gg, Gg, Gg, Gg
