Ww, Gg, Gg, Gg, Gg, Gg, Gg, Gg, Gg, Gg, Gg, Gg, Gg, Gg, Gg, Gg, Gg, Gg, Gg, Gg, Gg, Gg, Gg, Gg, Gg, Gg, Gg, Gg, Gg, Gg, Gg, Gg, Gg, Gg, Gg, Gg, Gg, Gg
Wo, Ww, Wo, Gg, Ww, Gg, Gg, Gg, Gg, Gg, Gg, Gg, Gg, Gg, Gg, Gg, Gg, Gg, Gg, Gg, Gg, Gg, Gg, Gg, Gg, Gg, Gg, Gg, Gs^Fds, Gg, Gg, Gg, Gg, Gg, Gg, Gg, Gg, Gg
Ww, Wo, Wo, Ww, Wo, Ww, Gg, Gg, Gg, Gg, Sm, Gg, Gg, Gg, Gg, Gg, Gg, Gg, Gg, Gg, Gg, Gs^Fms, Gg, Gs^Fds, Gg, Gs^Fms, Gs^Fms, Gs^Fds, Gs^Fms, Gg, Gg, Gg, Gg, Gg, Gg, Gg, Ww, Gg
Gg, Ww, Wo, Wo, Wo, Ww, Ww, Gg, Wo, Sm, Wo, Sm, Sm, Gg, Wo, Gg, Ww^Ewl, Gg, Gg, Gg, Gs^Fds, Gs^Fms, Gs^Fds, Gs^Fms, Gg, Gs^Fds, Gg, Gg, Gg, Gg, Gg, Gg, Gg, Gg, Ww, Ww, Wo, Wo
Gg, Gg, Gg, Ww, Wo, Wo, Wo, Wo, Wo, Wo, Wo, Wo, Wo, Wo, Wo, Wo, Wo, Ss, Ss, Gg, Gg, Gg, Gg, Gg, Sm, Gg, Gg, Gg, Ww, Ss, Ss^Vhs, Ss, Ww, Ww, Wo, Wo, Wo, Wo
Gg, Gg, Gg, Gg, Gg, Wo, Ww, Wo, Ww, Wo, Ww, Wo, Wo, Wo, Wo, Wo, Wo, Wo, Ww, Gg, Gs, Gg, Ss, Ss, Ww^Ewf, Sm, Wo, Ww, Wo, Ww, Wwr, Ww, Wo, Wo, Wo, Wo, Wwr, Wwrg
Gg, Gg, Gs^Fds, Gg, Gg, Gg, Gg, Ww, Gg, Ww, Gg, Wwr, Sm, Sm, Sm, Wo, Wo, Wo, Wo, Ww, Wo, Ss, Ww^Ewl, Ww^Ewf, Wo, Ww^Vm, Wo, Wo, Wo, Wo, Wo^Bw|r, Wo, Ss, Ss, Ww^Ewl, Ww^Ewl, Gg, Gg
Gg, Rp, Rp, Gs^Fms, Gs^Fds, Gg, Gg, Gg, Gg, Gg, Gg, Gg, Gg, Gg, Gg, Gg^Efm, Gg, Wo, Wo, Wo^Es, Wo, Wo, Ww, Ww, Wo, Wo, Wo, Wo, Chw, Ss, Khs, Ss, Chr, Ss, Ww^Vm, Rp, Gg, Gg
Gg, Gg, Gg, Gg, Gg, Gg, Gg, Gg, Gg, Gg, Gg^Efm, Gg, Gs^Fds, Gg, Gs^Fms, Gg, Gg^Es, Gg, Gg, Wo, Ww, Ww^Es, Wo, Ww, Ww^Ewl, Wo, Sm, Ss^Vhs, Gg, Chr^Dr, Chr, Chr^Dr, Sm, Ss, Sm, Hhd, Hhd, Rp
Gg, Gg, Gg, Gg, Gg, Rp, Rp, Gg, Gg, Gg, Gg, Gg, Gs^Fds, Gg, Gg, Gs^Fds, Gg, Gg, Gg, Gg^Efm, Ss^Vhs, Ss, Ss, Ww^Ewf, Gg, Sm, Gg, Gg^Es, Ss, Gg, Gg^Es, Gg, Ss, Sm, Hhd, Hhd, Hhd, Gg
Gg, Gg, Gg, Gg, Gg, Gg, Gs, Rp, Gs^Fms, Gg, Gg, Gg, Gs^Fds, Gs^Fms, Gs^Fds, Gs^Fms, Gg, Gg, Gg, Gg^Efm, Gg, Gg, Gg, Gg, Gg, Gg, Rp, Gg, Sm, Sm, Ss, Gg, Gg, Hhd, Hhd^Es, Hhd, Hhd, Gg
Gg, Gg, Gg, Gg, Gg, Gg, Ce, Gg, Gg, Gg, Rp, Gg, Gg, Gg^Es, Gg, Gg, Gg, Gg, Rp, Gg, Rp, Gg, Gg^Es, Gg, Gg, Rp, Gg, Gg, Sm, Ww, Ss, Gg, Hhd, Hhd, Hhd, Hhd, Hhd, Gg
Gg, Gg, Gg^Es, Re^Vct, Gg, Ce, Ke, Ce, Gg, Hh, Hh, Gg, Rp, Gg, Gg, Gg, Rp, Rp, Gg, Rp, Gg, Rp, Gg, Gg, Rp, Gg, Gg, Gg, Gg, Ww, Ss, Gg, Hhd, Hhd, Hhd, Gs, Gg, Gg
Gg, Gg, Gg, Gg, Gg, Ce, Ce, Ce, Gg, Gg, Gg, Gg, Gs^Fds, Rp, Rp, Rp, Gg, Gg, Gg, Gg, Gg, Gg, Gg, Gg, Gg, Rp, Rp, Gg, Gg, Ss^Vhs, Gg^Efm, Gg, Gg, Hhd^Es, Hhd, Hhd, Gg, Gg
Gll^Fp, Gll^Fp, Gll^Fp, Gg, Gg, Gg, Gg, Gg, Gg, Gg, Gs^Fds, Gs^Fds, Gs^Fds, Gs^Fds, Gs^Fds, Gg, Gg, Gg, Gg, Gg, Gg, Gg, Gs, Gg^Es, Gg, Gg, Gg, Rp, Rp, Gg, Gg, Gg, Gg, Gg, Gg, Gg, Gg, Gg
Gg, Gll^Fp, Gs^Fds, Gll^Fp, Gll^Fp, Gg, Gg, Gg, Gll^Fp, Gg, Gs, Gs^Fms, Gs^Fms, Gs^Fds, Gs, Gs^Fds, Gs, Gs^Fds, Gs^Fds, Gg, Gg, Gg, Gg, Gg^Efm, Gg, Gg, Gg, Gg, Gg, Rp, Gg, Gg, Rp, Rp, Rp, Gg, Gg, Rp
Gg, Gs^Fds, Gs^Fds, Gs^Fds, Gs^Fds, Gs^Fds, Gs^Fds, Gs^Fds, Gs^Fds, Gs^Fds, Gs^Fds, Gs, Gs, Gs^Fms, Gs^Fds, Gs, Gs^Fds, Gs^Fms, Gs^Fds, Gg, Gg, Gg, Gg, Gg, Gg, Gg, Gg, Gg, Gg, Gg, Gg, Gg, Gg, Gg, Gg, Gg, Gg, Gg
Gg, Gll^Fp, Gll^Fp, Gs^Fds, Gs^Fds, Gll^Fp, Gs^Fds, Gs^Fds, Gs^Fms, Gs^Fms, Gs^Fms, Gs^Fds, Gs^Em, Gs^Fds, Gs^Fds, Gs^Fds, Gs, Gs^Fds, Gs^Fds, Gg, Hhd, Gg, Hhd, Hhd, Gs, Gg, Gs, Gg, Gg, Gg^Es, Gg, Gg, Gg, Gg, Gg, Gg, Gs^Fds, Gs^Fds
Gg, Gs^Fds, Gs^Fds, Gs^Fds, Gs^Fds, Gs^Fds, Gs^Fds, Gs^Fds, Gs^Fms, Gs^Fds, Gs^Fds, Gs^Fds, Gll^Fp, Gs^Fms, Gs^Fds, Gs, Gs, Gs^Fds, Hhd, Hhd, Hhd, Hhd, Uu^Vu, Hhd, Hhd, Hhd, Hhd, Gs, Gg, Gg, Gg, Gg, Gg^Es, Gg, Gs^Fds, Gs^Fds, Gs^Fds, Gs^Fds
Gs^Fds, Gs^Fms, Gs^Fds, Gs^Fms, Gs^Fms, Gs^Fms, Gs^Fds, Gs^Fds, Gs^Fds, Gs^Fds, Gs^Fds, Gs^Fds, Gs^Fds, Gs^Fds, Gs^Fds, Gs^Fds, Hhd, Hhd, Uu^Vu, Hhd, Hhd^Fds, Hhd, Hhd^Edb, Hhd, Hhd, Hhd, Hhd, Hhd, Gg, Gg, Gg, Gg, Gg, Gs^Fds, Gs^Fms, Gs^Fms, Gs^Fds, Gs^Fds
Gs^Fds, Gs^Fms, Gs^Emf, Gs^Fds, Gll^Fp, Gs^Fds, Gs^Em, Gs^Fms, Gs^Fds, Gs^Fds, Gs^Fds, Gs^Fds, Hhd, Gs^Fds, Hhd, Hhd, Hhd, Hhd, Hhd^Es, Hhd, Hhd^Fds, Hhd, Hh^Kov, Hhd, Hhd, Uu^Vu, Hhd, Hhd, Hhd, Gg, Gg, Gg, Gs^Fds, Gs^Fds, Gs^Fds, Gs^Fds, Gs^Fds, Gs^Fds
Gs^Fds, Gs^Fds, Gs^Fds, Gs^Fds, Gs^Fms, Gs^Fds, Gs^Fds, Gs^Fds, Gs^Fds, Gs^Fds, Gs^Fds, Gs^Fds, Hhd, Hhd, Hhd^Es, Hhd^Fds, Hhd^Fds, Hhd, Hhd, Hhd^Fds, Hhd, Hhd, Hhd, Hhd, Hhd, Hhd, Hhd^Edb, Hhd, Gg, Gg, Gg, Gg, Gs^Fds, Gs^Emf, Gs^Fms, Gs^Fds, Gs^Fds, Gs^Fds
Gs^Fds, Gs^Fds, Gs^Fds, Gs^Fds, Gs^Fds, Gs^Fds, Gs^Fds, Gs^Fds, Gs^Fds, Gll^Fp, Gs^Fds, Hhd, Hhd, Hhd, Hhd, Hhd, Hhd, Hhd^Es, Hhd, Hhd, Hhd, Hhd, Hhd, Hhd, Hhd, Hhd, Hhd^Fds, Hhd^Fds, Hhd^Fds, Gg, Gs^Fds, Gs^Fds, Gs^Fms, Gs^Fds, Gs^Fds, Gs^Fms, Gs^Fds, Gs^Fds
Gg, Gs^Fds, Gg, Gs^Fds, Gg, Gs^Fds, Gg, Gs^Fds, Gg, Gs^Fds, Gg, Mm, Gg, Hhd, Gg, Mm, Gg, Mm, Mm, Mm, Gg, Hhd, Gg, Mm, Gg, Hhd^Fds, Hh, Hhd^Fds, Hhd^Fds, Hhd^Fds, Gg, Gs^Fds, Gs^Fds, Gs^Fds, Gs^Fds, Gs^Fds, Gs^Fds, Gs^Fds
