Gg, Gg, Gg, Gg, Ss, Gg, Gg, Gg, Gg, Gg, Gg, Gg, Gg^Efm, Gg, Gg, Gg, Gs^Fms, Gg, Gs^Fms, Gg, Gg, Gg, Gg, Gg, Gg, Gg, Gg, Gg, Gg, Gg, Gg, Gg, Gg, Gg, Gs^Fds, Gg, Gs^Fds, Gg, Gg, Gg, Gs^Fds, Gg, Gs^Fds, Gg, Gg, Gg
Wo, Wo, Wo, Ww^Ewl, Ww^Ewl, Ww^Ewf, Wo, Gg, Gg, Gg, Gg, Gg^Efm, Gg, Gg, Gg, Gs^Fms, Gs^Fms, Gs^Fms, Gs^Fms, Gs^Fms, Gg, Gg, Gg^Efm, Gg, Gg^Efm, Gg, Gg, Gg, Gg, Gg, Gg, Gg, Gg, Gs^Fds, Gs^Fds, Gs^Fds, Gg, Gg, Gg, Gg, Gs^Fds, Gs^Fds, Gg, Gg, Gg, Gg
Wo, Wo, Wo, Wo, Wo, Wo, Wo, Wo, Wo, Gg, Wo, Gg, Gg, Gg, Gg, Gs^Fms, Gg, Gs^Fms, Gg, Gg, Gg, Gg, Gg^Efm, Gg^Efm, Gg, Gg, Gg, Gg, Ss, Ss, Wo, Gg, Gg, Gg, Wo, Gg, Wo, Gg, Wo, Gg, Gg, Gs^Fds, Gg, Gg, Gg, Gg
Ss, Wo, Ss, Wo, Wo, Wo, Wo, Wo, Wo, Wo, Wo, Wo, Wo, Wo, Wo, Gg, Wo, Gg, Wo, Gg, Gg, Gg, Gg, Gg, Wo, Gg, Wo, Ss, Wo, Wo, Wo, Wo, Wo, Wo, Wo, Wo, Wo, Wo, Wo, Wo, Wo, Gg, Ss, Ss, Ss, Gg
Gg, Ss, Ss, Ss, Ss, Gg, Gg, Wo, Wo, Wo, Wo, Wo, Wo, Wo, Ww^Ewf, Wo, Wo, Wo, Wo, Wo, Wo, Ss, Wo, Wo, Wo, Wo, Wo, Wo, Wo, Wo, Wo, Wo, Wo, Wo, Wo, Wo, Wo, Wo, Wo, Wo, Wo, Wo, Wo, Wo, Wo, Wo
Gg, Gg, Gg, Gg, Gg, Gg, Gg, Hhd, Hhd, Wo, Wo, Wo, Wo, Wo, Wo, Wo, Wo, Wo, Wo, Wo, Wo, Wo, Wo, Wo, Wo, Wo, Wo, Wo, Wo, Wo, Gs, Wo, Gg, Wo, Hhd, Wo, Gg, Wo, Wo, Wo, Wo, Wo, Wo, Wo, Wo, Wo
Gg, Gg, Gg^Efm, Gg, Gg, Gg, Gg, Hhd, Hhd, Hhd, Hhd, Hhd, Hhd, Hhd, Hhd, Wo, Hhd, Wo, Hh, Ww^Ewf, Ss, Ss, Ss, Wo, Gs^Fms, Wo, Gs^Fms, Gs^Fms, Gs, Gg, Gs, Gs, Hhd, Hhd, Hhd, Hhd, Hhd, Gg, Gg, Gg, Gg, Ss, Ss, Wo, Gg, Wo
Gg, Gg, Gg^Efm, Gs^Efm, Gs, Gg, Gg, Gg, Hhd, Hhd, Hhd, Hhd, Hhd, Hhd, Hhd, Hhd, Hhd, Hhd, Gs, Gg, Gg, Gs^Fms, Hh, Gs^Fms, Gd^Vu, Gs^Fms, Hh, Gs, Hh, Gs, Gs, Gg^Fet, Hhd, Hhd, Hhd, Hhd^Fmf, Hhd^Fmf, Hhd, Hhd, Hhd, Hhd, Gg, Gg, Gg^Efm, Gg, Gg
Gg, Gg, Gg, Gg, Gg, Gg, Gg, Gg, Hhd, Hhd, Hhd, Hhd^Vu, Hhd, Hhd, Hhd, Hhd, Hhd, Hhd, Hhd, Gs, Gs, Qxua, Hh, Hh, Hh, Hh, Hh, Hh, Hh, Hh, Gs, Hhd, Hhd, Hhd, Hhd, Hhd^Fmf, Hhd^Fmf, Hhd^Edb, Hhd, Hhd, Hhd, Hhd, Gs, Gg, Gg, Gg
Gg, Gg, Ce, Ce, Ce, Gg, Gg, Gg, Hhd, Hhd, Hhd, Hhd, Hhd, Hhd, Gll^Fmf, Hhd, Hhd^Edb, Hhd, Gs, Gs, Hh, Qxua, Qxua, Hh, Hh, Hh, Hh^Fmf, Hh, Hh, Hh, Gs, Hhd, Hhd^Fmf, Hhd, Hhd, Hhd, Hhd, Hhd^Fmf, Hhd, Hhd, Hhd, Hhd, Hhd, Gs, Gs, Gg
Gg, Gg, Ce, Ket, Ce, Gg, Gg, Gg, Hhd, Hhd, Hhd, Hhd, Hhd, Gll^Fmf, Gg^Fet, Hhd, Gs^Dr, Gs^Dr, Gs, Hh, Hh, Hh, Hh, Hh, Hh, Hh^Fmf, Hh, Hh, Hh, Hh^Edb, Hh, Gg, Hhd^Fmf, Hhd, Hhd, Hhd^Vu, Hhd, Hhd, Hhd, Hhd, Hhd, Hhd, Hhd, Gs, Gs, Gg
Gg, Gg, Gg, Ce, Gg, Gg, Gg, Gg, Gg, Hhd, Hhd, Hhd, Gs, Gs, Gs, Gs, Gs, Gs, Hh, Hh, Hh, Hh, Hh, Hh^Dr, Hh, Hh^Edb, Hh, Hh, Hh, Hh, Hh, Gg, Gg, Hhd^Fmf, Hhd, Hhd, Qxua, Hhd, Hhd, Hhd, Hhd, Hhd, Gs^Efm, Gs^Efm, Gg, Gg
Gg, Gg, Gg, Gg^Efm, Gs, Gs, Gs, Gg, Gs, Gs, Gs, Gs, Gs, Hhd, Hhd, Gs, Gg, Gs, Gs, Hh, Hh, Hh, Hh, Hh, Hh, Hh, Hh^Fmf, Hh, Hh^Fmf, Hh, Hh, Hh, Gs, Gg, Gs, Hhd, Qxua, Hhd, Hhd, Hhd, Hhd, Gs, Gs, Gs^Efm, Gg, Gg
Gg, Gg, Gg, Gg, Gg, Gg, Gd^Vu, Gg, Gs, Gs, Hhd, Gs, Hhd^Edb, Hhd, Hhd, Hhd, Hhd, Gg, Gg, Gs, Hh, Hh, Hh, Hh, Hh, Hh, Hh^Fmf, Hh^Fmf, Hh, Hh, Hh, Hh, Gs, Hhd, Hhd, Gs, Qxua, Gs, Gs, Gll^Fmf, Gll^Fmf, Gs, Hhd, Gs, Gg, Gg
Gs^Fds, Gs^Fds, Gs^Fds, Gg, Hhd, Hhd, Hhd, Gs, Hhd, Hhd, Hhd, Hhd, Hhd^Fmf, Hhd, Hhd, Hhd, Hhd, Hhd, Gg, Gs, Gs, Hh, Hh, Hh^Es, Gd^Vu, Hh, Hh, Hh, Hh, Hh, Hh, Hh, Gs, Hhd, Hhd^Edb, Hhd, Hhd, Hhd, Gll^Fmf, Gll^Fmf, Gll^Fmf, Hhd, Hhd, Hhd, Gg, Gg
Gs^Fds, Gs^Fds, Gs^Fds, Gs^Fds, Hh, Hhd, Hhd, Gs, Gs, Hhd, Hhd, Hhd, Hhd, Hhd^Fmf, Hhd^Es, Hhd, Gs, Gd, Gs, Gs, Hhd^Es, Gs, Gs, Gs, Gs, Hh, Gs, Hh, Gg^Efm, Hh, Gs, Gs, Gs, Gs, Gll^Fmf, Hhd^Fmf, Hhd, Hhd, Hhd, Gll^Fmf, Hhd, Hhd, Hhd, Hhd, Gg, Gg
Gs^Fds, Gs^Fds, Gs^Fds, Gs^Fds, Hhd, Hhd, Hhd, Gs, Gs, Hhd^Edb, Hhd, Hhd, Gd, Hhd, Hhd, Hhd, Gs^Dr, Gs^Dr, Gs, Hhd, Hhd, Hhd, Hhd, Gs, Gs, Gs, Gs, Gg, Gd, Gs, Gs, Qxua, Qxua, Hhd, Gll^Fmf, Gll^Fmf, Gs, Hhd, Hhd^Fmf, Hhd, Hhd, Hhd, Hhd, Hhd, Gg, Gg
Gs^Fds, Gs^Fds, Gs^Fds, Gs^Fds, Hhd, Hhd, Hhd, Gs^Efm, Gs^Dr, Gs^Dr, Hhd, Hhd, Hhd^Vu, Gd, Hhd, Hhd, Hhd, Gs^Dr, Hhd, Hhd, Qxu, Hhd, Hhd, Hhd, Hhd, Gd^Fetd, Hhd^Edb, Gs, Hhd, Gs^Es, Gs, Chr, Hhd, Hhd, Hhd, Gll^Fmf, Hhd, Hhd^Fmf, Hhd, Hhd, Hhd, Hhd, Gg, Gg, Gg^Efm, Gg
Gs^Fds, Gs^Fds, Hh, Hh, Hh, Hh, Hhd, Hhd, Hhd, Hhd, Hhd, Hhd, Hhd, Hhd, Hhd, Hhd, Hhd^Es, Hhd, Hhd, Hhd, Qxu, Qxu, Hhd, Hhd, Hhd, Hhd, Hhd, Hhd, Hhd, Hhd, Hhd, Hhd, Hhd, Hhd, Hhd, Hhd, Hhd, Hhd^Vu, Hhd, Hhd, Hhd, Hhd, Gg, Gg, Gg, Gg
Gs^Fds, Gs^Fds, Gs^Fds, Hh, Hh, Hh, Hh, Hhd, Hhd, Hhd, Hhd, Hhd, Hhd, Hhd, Hhd, Hhd, Hhd, Hhd, Hhd, Hhd, Hhd, Hhd, Mm^Xm, Mm, Mm^Xm, Hhd, Hhd^Dr, Hhd, Hhd, Hhd, Hhd^Es, Hhd, Hhd, Hhd, Qxu, Hhd, Hhd, Hhd, Hhd, Hhd, Hhd, Hhd, Gg, Gg, Gg, Gg
Gs^Fds, Gs^Fds, Hh, Hh, Hh, Hh, Hh, Hh, Mm, Hhd, Hhd, Hhd, Mm, Mm, Mm, Mm, Mm, Hhd, Hhd, Hhd, Hhd, Hhd, Mm, Mm^Xm, Mm, Mm, Mm, Hhd^Vu, Hhd, Hhd, Hhd, Hhd, Hhd, Qxu, Hhd, Hhd, Hhd, Hhd, Hhd, Hhd, Hhd, Mm, Mm, Gg, Gg, Gg
Gs^Fds, Gs^Fds, Hh, Hh, Hh, Hh, Mm, Hh, Mm, Mm, Hhd, Mm, Mm, Mm, Mm, Mm, Mm, Mm, Mm, Hhd, Mm, Mm, Mm, Mm, Mm, Mm, Mm, Mm, Mm, Mm, Mm, Hhd, Hhd, Hhd, Hhd, Hhd, Hhd, Hhd, Hhd, Hhd, Mm, Mm, Mm, Gg, Gg, Gg
Gs^Fds, Gs^Fds, Mm, Hh, Mm, Mm, Mm, Mm, Mm, Hhd, Mm, Mm, Mm, Mm, Mm, Mm, Mm, Mm, Mm, Mm, Mm, Mm, Mm, Mm, Mm, Mm, Mm, Mm, Mm, Mm, Mm, Mm, Mm, Hhd, Mm, Hhd, Mm, Mm, Md, Md, Md, Mm, Mm, Mm, Gg, Gg
Gs^Fds, Gs^Fds, Mm, Mm, Mm, Mm, Mm, Mm, Mm, Mm, Mm, Mm, Mm, Mm, Mm, Mm, Mm, Mm, Mm, Mm, Mm, Mm, Mm, Mm, Mm, Mm, Mm, Mm, Mm, Mm, Mm, Mm, Mm, Mm, Mm, Mm, Hh, Mm, Md, Md, Md, Mm, Mm, Mm, Gg, Gg
Gg, Gs^Fds, Mm, Mm, Mm, Mm, Mm, Mm, Mm, Mm, Mm, Mm, Mm, Mm, Mm, Mm, Mm, Mm, Mm, Mm, Mm, Mm, Mm, Mm, Mm, Mm, Mm, Mm, Mm, Mm, Mm, Mm, Mm, Mm, Mm, Hh, Hh, Gg, Gg, Md, Gg, Gg, Gg, Gg, Gg, Gg
