Gg, Gg, Gg, Gg, Gg, Gg, Gg, Gg, Gg, Gg, Gg, Gg, Gg, Gg, Ds, Wwt, Wwt, Wo, Wot, Wot, Wot, Wot, Wot, Wot, Wot, Wot, Wot, Wot, Wot, Wo, Wot, Wot, Wot, Wot, Wwt, Wot, Wot, Wot, Wot, Wot, Wot, Wot, Wot, Wot, Wot, Wot
Gg, Gg, Gg, Gg, Gs^Ftp, Gg, Gg, Gg, Gg, Gg, Gs^Ftp, Gg, Gg, Gg, Ds, Wwt, Wot, Wot, Wot, Wot, Wot, Wot, Wwrt, Wwrt, Wot, Wot, Wot, Wot, Wot, Wot, Wot, Wot, Wwt, Wwt, Dd, Wwt, Gg, Wot, Gg, Wot, Wot, Wot, Wot, Wot, Wot, Wot
Gg, Gg, Gs^Ftp, Gs^Ftp, Gs^Ftp, Gs^Ftp, Gs^Ftp, Gg, Gs^Ftp, Gs^Ftp, Gg, Gg, Ds, Ds, Ds, Wwt, Wot, Wot, Wot, Wot, Wot, Wwrt, Wwrt, Wot, Wot, Wot, Wot, Wot, Wot, Wot, Wot, Wwt, Dd, Dd, Dd^Ftd, Gg, Rr^Vd, Ss, Gg, Gg, Gg, Wot, Wot, Wot, Wot, Wot
Gg, Gg, Gs^Ftp, Gs^Ftp, Gs^Ftp, Gs^Ftp, Gg, Gs^Ftp, Gg, Gg, Gg, Gg, Ds, Ds, Wwt, Wwt, Wot, Wot, Wot, Wot, Wot, Wot, Wot, Wot, Wot, Wot, Wot, Wot, Wot, Wot, Wot, Gg, Gg, Gg, Gs^Ftp, Gg, Hh, Gg, Hh, Rr^Vd, Gg, Gg, Gg, Wot, Wot, Wot
Gg, Gs^Ftp, Gs^Ftp, Gs^Ftp, Gs^Ftp, Gg, Gs^Ftp, Gs^Ftp, Gg, Gg, Dd^Do, Ds, Ds, Ds, Wwt, Wwt, Wot, Wot, Wot, Wot, Wot, Wot, Wot, Wot, Wot, Wot, Wot, Wot, Wot, Wot, Wot, Gg, Gg, Rr^Vd, Gs^Ftp, Co, Ko, Co, Hh, Hh, Hh, Gg, Rp, Wot, Wot, Wot
Gs^Ftp, Gs^Ftp, Gg, Gs^Ftp, Gs^Ftp, Gs^Ftp, Gs^Ftp, Gs^Ftp, Dd^Ftd, Dd^Ftd, Ds, Ds, Wwt, Ds, Wwt, Wwt, Wot, Wot, Wot, Wot, Wot, Wot, Wot, Wot, Wot, Wot, Wot, Wot, Wot, Wot, Wwt, Wwt, Gg, Gs^Ftp, Gg, Co, Co, Co, Hh, Hh, Hh, Rr^Vd, Rp, Gg, Wot, Wot
Gg, Gs^Ftp, Gs^Ftp, Gs^Ftp, Gs^Ftp, Gs^Ftp, Gg^Es, Dd^Ftd, Dd^Ftd, Ds, Wwt, Wwt, Wwt, Wwt, Wot, Wot, Wot, Wot, Wot, Wot, Wot, Wot, Wot, Wot, Wot, Wot, Wot, Wot, Wot, Wwt, Wwt, Wwt, Ss, Gg, Gg, Gg, Gg, Gg, Gs^Ftp, Gs^Ftp, Gs^Ftp, Gg, Gg, Gg, Wot, Wot
Gg, Gg, Gg, Gg, Gs, Gg, Gg^Edb, Chs, Chs, Wwt, Wot, Wwt, Wot, Wot, Wot, Wot, Wot, Wot, Wot, Wot, Wot, Wot, Wot, Wot, Wot, Wot, Wwt, Wot, Wwt, Wwt, Ss, Gg, Ss, Ss, Gg, Gg, Gg, Gg, Gs^Ftp, Gs^Ftp, Gg, Gg, Gg, Gg, Wot, Wot
Gg, Gg, Gg^Es, Gg, Gg, Gg, Gg, Ds, Wwt, Wwt, Wot, Wot, Wot, Wot, Ss, Wot, Wot, Wot, Wot, Wot, Wot, Wot, Wwt, Wwt, Wwt, Wwt, Ds, Wwt, Gg, Gg, Ss, Ss, Gg, Gg, Rr^Vd, Hh, Gg, Gg^Efm, Gg, Gg, Gg, Gg, Gg, Gg, Wwt, Wot
Gg, Gg, Gg, Gg, Gg, Gg, Ds, Ds, Wwt, Wwt, Wot, Wot, Ss, Ss, Gg, Wot, Wot, Wot, Wot, Wwr, Wwt, Wwt, Dd, Ds, Ds, Ds, Ds, Ds, Gg, Ss, Ss, Gg, Gs^Ft, Gg, Gg, Gg, Gg, Gg, Gg, Rr^Vd, Gg, Gg, Dd, Dd, Wwt, Wot
Gg, Gg, Gg, Gg, Ds, Ds, Wwt, Wwt, Wot, Wot, Wwt, Ss, Gs^Vht, Gg, Gg, Wot, Wwt, Wot, Wot, Wwt, Wwt, Wwt, Dd, Dd, Dd, Gg, Gg, Gg, Sm, Gg, Ss, Gg, Gs^Ft, Gg, Gg, Gs^Ft, Gg, Gg, Gg, Gg, Gg, Gg, Dd, Wwt, Wwt, Wot
Gg, Gg, Ds^Bw\r, Ds, Wwt, Wwt, Wot, Wot, Wwt, Wwt, Gg, Ss, Ss, Gg, Gg, Wwt, Wwt, Wwt, Wwt, Wwf, Wwf, Dd, Dd, Gg, Gg, Gg, Gg, Gg, Sm, Rr^Vd, Ss, Gg, Gs^Ft, Gs^Ft, Gg, Gg, Ss, Ss, Gg, Gg, Gg, Dd, Wwt, Wwt, Wot, Wot
Wwt, Wwt, Wwt, Wwt, Wot, Wot, Wot, Wot, Wwt, Ss, Gs^Ftp, Gs^Ftp, Chs, Gg, Wwf, Wwf, Wwf, Wwr, Wwr, Wwr, Wwf, Dd, Gg, Ss, Ss, Gg, Hh, Gg, Gg, Sm, Gg, Gg, Gg, Gg, Gg, Ss, Gg, Ss, Wwt, Wwt, Wwt, Wwt, Wot, Wot, Wot, Wot
Wwt, Wwt, Wot, Wot, Ss, Wot, Wot, Wot, Ss^Bw/r, Gg, Gg, Gs^Ftp, Chs, Chs, Wwt, Wwt, Wwt, Wwt, Wwt, Wwt, Ds, Gg, Gg, Gg, Rr^Vd, Hh, Hh, Gg, Gg, Gg, Gs^Ft, Gs^Ft, Gg, Rr^Vd, Gg, Gg, Wwt, Wwt, Wwr, Wwt, Wot, Wot, Wot, Wot, Wot, Wot
Wot, Wot, Wot, Ss, Ss, Wot, Wot, Wot^Bw/r, Wot, Ss, Ss, Gg, Wwf, Wwt, Wot, Wwt, Wot, Wot, Wwt, Wwt, Ds, Ds, Dd^Ftd, Gg, Gg, Gg, Gg, Gg, Ss, Gg, Gs^Ft, Gs^Ft, Gs^Ft, Gg, Gg, Gg, Wwt, Wot, Wwr, Wwt, Gg, Wot, Wot, Wot, Wot, Wot
Wo, Wot, Wot, Wot, Wot, Wot, Wot, Wot, Wot, Wwt, Wwt, Wwf, Wwf, Wwt, Wwt, Wot, Wot, Wot, Wot, Wwt, Wwt, Ds, Ds, Dd^Ftd, Gg, Gg, Ss, Ss, Rr^Vd, Sm, Gg, Gs^Ft, Gg, Gg, Gg, Gg, Wwt, Wwt, Wwt, Gg, Gg, Gg, Gg, Wot, Wot, Wot
Gg, Wot, Wot^Bw/r, Wot, Wot, Wot, Wot, Wot, Wot, Wwt, Wwf, Wwf, Wwf, Wwt, Wwt, Wwt, Wot, Wot, Wot, Wwt, Wwt, Ds, Ds, Gd, Gg, Gg, Ss, Gg, Rp, Sm, Gg, Gg, Gg, Gg, Gg, Wwt, Wot, Wot, Wot, Gg, Rr^Vd, Gg, Gg, Wot, Wot, Wot
Gg, Gg, Gg, Ss, Ss, Ss, Ss, Ss, Ds, Ds, Ds, Wwf, Wwf, Wwt, Wwt, Wwt, Wwt, Wot, Wot, Wwt, Wwt, Wwt, Wwt, Wwt, Wwt, Wwt, Wot, Wwt, Wwt, Rp, Wwt, Gg, Wwt, Gg, Wot, Wot, Wot, Wot, Wot, Gg^Edb, Hh, Gs^Ftp, Gg, Wot, Wot, Wot
Gg, Gg, Gg, Gg, Gg, Gg, Gg, Ds, Ds, Ds, Ds, Ds, Ds, Wwt, Wwt, Wwt, Wwt, Wot, Wot, Wot, Wot, Wwt, Wwrt, Wwt, Wot, Wot, Wot, Wot, Wot, Wwt, Wot, Wwt, Wot, Wot, Wot, Wot, Wot, Wot, Gg, Gg, Hh, Hh, Gg, Wot, Wot, Wot
Gg, Gg, Gg, Gg^Es, Gg, Gg, Gg, Gg, Gg, Dd^Vda, Dd^Dc, Ds, Ds, Ds, Wwt, Wwt, Wot, Wot, Wot, Wot, Wot, Wot, Wwrt, Wwt, Wot, Wot, Wot, Wot, Wot, Wot, Wwt, Wwt, Wot, Wot, Wot, Wwt, Gg, Gg, Gs^Ftp, Hh, Hh, Rr^Vd, Gg, Wot, Wot, Wot
Gg, Gs^Ft, Gg, Gg, Gs^Ft, Gg, Ce, Gg, Gg, Gg, Ds, Ds, Ds, Ds, Wwt, Wwt, Wot, Wot, Wot, Wot, Wot, Wot, Wot, Wwrt, Wwrt, Wot, Wot, Wot, Wot, Wwt, Wwt, Wot, Wot, Wot, Wot, Wwt, Gg, Gs^Ftp, Rr^Vd, Hh, Gg^Edb, Gg, Wot, Wot, Wot, Wot
Gg, Gs^Ft, Gs^Ft, Gs^Ft, Gs^Ft, Gs, Ket, Ce, Gg, Gg, Gg, Ds, Ds, Ds, Wwt, Wwt, Wwt, Wot, Wot, Wot, Wot, Wot, Wot, Wwrt, Wwrt, Wwrt, Wwt, Wot, Wot, Wwt, Wot, Wot, Wot, Wot, Wot, Wwt, Gg, Gs^Ftp, Gs^Ftp, Ss, Gg, Gg, Wot, Wot, Wot, Wot
Gs^Ft, Gs^Ft, Gs^Ft, Gs^Ft, Gs^Ft, Gs, Ce, Ce, Gg, Gg, Gg^Es, Dd^Vdt, Ds, Ds, Wwt, Wwrt, Wwt, Wwt, Wwt, Wot, Wot, Wot, Wwt, Wwt, Wot, Wot, Wot, Wwrt, Wwrt, Wwrt, Wwrt, Wot, Wot, Wot, Wot, Wwt, Gg, Gg, Wwt, Wwt, Wot, Wot, Wot, Wot, Wwrt, Wot
Gs^Ft, Gs^Ft, Gs^Ft, Gs^Ft, Gs^Ft, Gs, Gg, Gg, Gg, Gg, Ds, Gg, Ds, Wwt, Wwt, Wwt, Wwt, Wwt, Wwrt, Wwrt, Wwt, Wwt, Wwt, Wot, Wot, Wot, Wot, Wot, Wot, Wot, Wwrt, Wot, Wot, Wot, Wot, Wwt, Wwt, Wwt, Wot, Wot, Wot, Wot, Wwrt, Wwrt, Wot, Wot
Gs^Ft, Gs^Ft, Gg, Gs^Ft, Gs^Ft, Gs^Ft, Gg, Gg, Ds, Ds, Dd^Do, Ds, Wwt, Wwt, Wwt, Ww^Vm, Wwt, Wwt, Wwt, Wwrt, Wwt, Wwt, Wot, Wot, Wot, Wot, Wot, Wot, Wot, Wwrt, Wwrt, Wwrt, Wot, Wot, Wwt, Wwt, Wwt, Wot, Wot, Wwrt, Wwrt, Wwrt, Wot, Wwrt, Wot, Wot
Gs^Ft, Gs^Ft, Gg, Gs^Ft, Gg, Gg, Gg, Ds, Ds, Ds, Ds, Ds, Wwt, Wwt, Wwt, Wwt, Wwt, Wwt, Wwt, Wwt, Ww^Vm, Wwt, Wwt, Wot, Wot, Wot, Wwt, Wot, Wwt, Wot, Wwt, Wwrt, Wwt, Wwt, Wwt, Wwt, Wwt, Wot, Wot, Wot, Wot, Wot, Wot, Wot, Wot, Wot
Gg, Gg, Gg, Gg, Gg, Gg, Ds, Ds, Dd^Ftd, Dd^Ftd, Ds, Wwt, Wwt, Ww^Vm, Wwt, Wwt, Chw, Wwt, Wwt, Wwt, Wwt, Wwt, Dd, Wwt, Wwt, Wwt, Wwt, Wwt, Ds, Wwt, Wwt, Wwt, Ds, Wwt, Ds, Wwt, Wwt, Wwt, Wwt, Wwt, Wwt, Wot, Wwt, Wwt, Wwt, Wwt
Gg, Gg, Gg, Gg, Gg, Gg, Gg, Ds, Dd^Ftd, Dd^Ftd, Ds, Wwt, Wwt, Wwt, Wwt, Chw, Khw, Chw, Wwt, Wwt, Wwt, Wwt, Ds, Ds, Ds, Ds, Ds, Ds, Ds, Ds, Ds, Ds, Ds, Ds, Ds, Ds, Ds, Wwt, Ds, Wwt, Ds, Wwt, Ds, Wwt, Wwt, Wwt
Gg, Gg, Gg, Gg^Es, Gg^Efm, Gg, Gg, Ds, Ds, Dd^Ftd, Ds, Ds, Wwt, Wwt, Wwt, Wwt, Wwt, Chw, Wwt, Ww^Vm, Wwt, Wwt, Ds, Dd^Do, Dd^Ftd, Hd, Hd, Ds, Dd^Do, Dd^Vda, Gg, Ds, Gg, Ds, Gg, Ds, Dd^Do, Ds, Hd, Ds, Ds, Ds, Ds, Ds, Ds, Wot
Gg, Gg, Gg, Gg^Efm, Gg, Gg^Efm, Gg, Gg, Gg, Ds, Ds, Ds, Ds, Wwt, Wwt, Wwt, Wwt, Wwt, Wwt, Wwt, Wwt, Ds, Ds, Hd, Hd, Hd, Gg, Dd^Ftd, Gs^Ftp, Gs^Ftp, Gg, Gg, Gg, Gg, Dd^Ftd, Hd, Hd, Hd, Gg, Gg, Gg, Gg, Gg, Ds, Ds, Ds
Hhd, Gg, Gg, Gg, Gg, Gg, Gg, Gg, Gg, Gg, Gg, Ds, Ds, Ds, Ds, Wwt, Ds, Wwt, Ds, Wwt, Ds, Ds, Hd, Hd, Gg, Gg, Gg, Gg, Gg, Gg, Gg, Gg, Gs^Ft, Gg, Gg, Gs^Ft, Gs^Ft, Dd^Ftd, Gg, Gg, Gg, Gg, Gg, Gg, Gg, Gg
Gg, Hhd, Gg, Gg, Gg, Gg, Gd^Fts, Gg, Gd^Fts, Gd^Fts, Gd^Fts, Gg, Gg, Ds, Ds, Ds, Ds, Ds, Ds, Ds, Ds, Ds, Gg, Gg, Gg^Efm, Gg, Gg, Gg, Gg, Gg, Gs^Ft, Gs^Ft, Gs^Ft, Gg, Gs^Ft, Gg^Efm, Gg, Gs^Ft, Gs^Ft, Gg^Efm, Gs^Ft, Gg, Gg, Gg, Gg, Gg
Gg, Hhd, Hhd, Gg, Gg, Gd^Fts, Gd^Fts, Gd^Fts, Gd^Fts, Gd^Fts, Gd^Fts, Gd^Fts, Gd^Fts, Gg, Gg, Ds, Gg, Gg, Gg, Ds, Gg, Gg, Gg, Gg, Gg, Gg^Efm, Gg, Gs^Ft, Gs^Ft, Gs^Ft, Gs^Ft, Gs^Ft, Gs^Ft, Gs^Ft, Gs^Ft, Gs^Ft, Gs^Ft, Gs^Ft, Gs^Ft, Gs^Ft, Gs^Ft, Gs^Ft, Gs^Ft, Gs^Ft, Gs^Ft, Gg
Gg, Hhd, Hhd, Gg, Gg, Gd^Fts, Gg, Gd^Fts, Gg, Gd^Fts, Gg, Gd^Fts, Gd^Fts, Gg, Gg, Gg, Gg, Gg, Gg, Gg, Gg, Gg, Gg, Gg, Gg, Gg, Gg, Gg, Gg, Gg, Gg, Gg, Gg, Gg, Gg, Gs^Ft, Gg, Gs^Ft, Gg, Gs^Ft, Gg, Gs^Ft, Gg, Gg, Gg, Gg
