Gg^Gvs, Gg^Gvs, Gg^Gvs, Gg^Vwm, Gg, Gg, Rr, Gg, Gg, Wwt, Wot, Wot, Wot, Wot, Wot, Wot, Gg, Ww^Ewf, Ww^Ewl, Ww^Ewf
Rp, Gg^Gvs, Gg, Gg, Rp, Gg, Rr, Gg, Gg, Gg, Wot, Wot, Wot, Wot, Wot, Gg, Gg, Gg, Gg, Gg
Gg, Rp, Rp, Rp, Gg^Dr, Rr, Gg, Rr, Rr, Ch, Rp^Vhcr, Wot, Wot, Wot, Wot, Gg, Gg, Gg, Gg, Gg
Gg, Gg, Gg, Gg, Gg, Ch, Ket, Ce, Gs^Vh, Rrc, Gg, Chr, Chr, Wot, Wot, Ww^Ewl, Gg^Es, Gg, Gg, Gg
Gg, Gg, Gg, Gg, Gg, Gg, Ce, Gg, Gg, Rrc, Gs^Vh, Gg, Gs^Vl, Ch, Wwt, Wwt, Wot, Gg, Gg, Gg^Efm
Gg, Gg, Gg^Gvs, Gg^Gvs, Gg^Gvs, Gg, Ce, Gs^Vh, Rrc, Rrc, Gg^Fet, Rrc, Rrc, Rrc, Wwt^Bsb\, Wwt, Wot, Gg, Gg, Gg
Gg, Gg^Gvs, Gg^Gvs, Gg^Gvs, Gg, Gg, Rr, Rrc, Gs^Vl, Rrc, Rrc, Rrc, Gg, Ce, Wwt, Wwt^Bsb\, Wwt^Bsb\, Gg, Gg, Gg
Gg, Gs^Vl, Gg, Gg, Rr, Rr, Gg, Ch, Ch, Gg, Gs^Vh, Gg, Gs^Vl, Ce, Wwt, Wwt, Wot, Rp, Rp, Gg^Es
Gg, Gg, Gg, Gg, Rr, Gg, Gg, Gg, Gg, Chr, Gg, Gg, Ce, Ce, Ww^Ewl, Wwt, Wot, Gg, Gg, Rp
Gg, Gg, Gg^Efm, Gg, Rr, Gg, Gg, Gg, Gg, Gg, Gg, Ce, Gg, Gg, Ww^Ewf, Wwt, Wot, Gg, Hh^Gvs, Gg
Gg, Gg, Gg, Rr, Gg, Gg, Gg, Gg, Gg, Gg, Gg, Gg, Gg, Gg, Wwt, Wwt, Wot, Gg, Hh^Gvs, Gs^Fms
